
I                                                          L
C                   a                                      E
C                  aY                                      E
C                 aY                         a             E
C                aY        aaaaa            aba            E
C               aY         JBBBK           ababa           E
C         a    aY         aFAAAGa         abababa          E
C         Ya   Y    a    aaFAAAGaa       ababababa         E
C          Ya      bY   JBBBBBBBBBK    JBBBBBBBBBBBK       E
C           Ya    aY    FAAAAAAAAAG    FAAAAAAAAAAAG       E
C            Y   bY                                        E
C               aY                                         E
C               Y                                          E
C                            000000000000000               E
C   ccc    Y      2     Y   0    0     0    0   0   0   111E
VBBBBBBBBBBBBBBBBBBBBBBBBBBBBBBBBBBBBBBBBBBBBBBBBBBBBBBBBBBT
AAAAAAAAAAAAAAAAAAAAAAAAAAAAAAAAAAAAAAAAAAAAAAAAAAAAAAAAAAAA